11111111
1000C001
1P000001
100000E1
11111111