11111111111111111111
100000000000E00P10C1
10000000000000001011
10000000000000000001
1000000000C000C00001
11111111111111111111